9, 6
1, 2
X X X X X X
X 0 0 0 0 X
X 0 0 0 0 X
X 0 0 0 0 X
X D 0 0 G X
X 0 0 0 0 X
X 0 0 D G X
X 0 P 0 0 X
X X X X X X