9, 6
1, 2
X X X X X X
X 0 0 0 0 X
X 0 0 0 T X
X 0 0 0 D X
X 0 0 0 G X
X 0 0 0 0 X
X 0 0 0 G X
X 0 P D 0 X
X X X X X X