9, 6
0, 5
X X 0 0 0 0
X X D X 0 X
X X 0 X 0 X
X X 0 X 0 X
0 0 0 0 0 X
0 X X X 0 0
0 X G 0 X P
0 0 X 0 X 0
X 0 0 0 0 0